{
	"name": "c01",
	"author": "softiron",
	"tiles": [
		"................",
		"................",
		"................",
		"................",
		"................",
		"................",
		"....1...........",
		"...111..........",
		"..11111----2....",
		"...111..........",
		"....1...........",
		"................",
		"................",
		"................",
		"................",
		"................"
	]
}
