{
	"name": "c02",
	"author": "softiron",
	"tiles": [
		"................",
		"................",
		"................",
		"................",
		"................",
		"................",
		"...1............",
		"..111...........",
		".11111---N---2..",
		"..111...........",
		"...1............",
		"................",
		"................",
		"................",
		"................",
		"................"
	]
}
