{
	"name": "c05",
	"author": "softiron",
	"tiles": [
		"................",
		"................",
		"................",
		".......23.......",
		"....1--22--1....",
		"....|..||..|....",
		"....|..||..|....",
		"...31--++--23...",
		"...13--++--31...",
		"....|..||..|....",
		"....|..||..|....",
		"....2--33--2....",
		".......11.......",
		"................",
		"................",
		"................",
	]
}
