{
	"name": "c06",
	"author": "softiron",
	"tiles": [
		"................",
		".........3......",
		"....4---4X2.....",
		"...1Y3..|1--2...",
		"...|2+--++-3Z1..",
		"...|.|1.||.|4|..",
		"...|.2X4||.|.|..",
		"...|..3+++4|.|..",
		"...2..|||1Y3.|..",
		"..3Z1-++++2..|..",
		"...4|.||4|...1..",
		"....|.|1X3..2Z4.",
		"....|3+-2----3..",
		"....4Y2.........",
		".....1..........",
		"................",
	]
}
