{
	"name": "c07",
	"author": "softiron",
	"tiles": [
		"................",
		"................",
		"................",
		".......44.......",
		"......4DD4......",
		"......4DD4......",
		".......44.......",
		".......||.......",
		".......||.......",
		".22....11....33.",
		"2BB2--1JJ1--3CC3",
		"2BB2--1JJ1--3CC3",
		".22....11....33.",
		"................",
		"................",
		"................",
	]
}
