{
	"name": "Patience is Divine",
	"author": "KaiN",
	"tiles": [
		"................",
		"................",
		"................",
		"................",
		"..Y--Y--Y.......",
		"..|..|..|.......",
		"..|..|..|.......",
		"..Y--Y--Y.......",
		"..|.............",
		"..|.............",
		"..1---------2-..",
		"................",
		"................",
		"................",
		"................",
		"................",
	]
}
