{
	"name": "Arms Race",
	"author": "KaiN",
	"tiles": [
		"................",
		"................",
		"................",
		"................",
		"...N---N---N....",
		"...|...|...|....",
		"...|..ZZZ..|....",
		"...|..ZZZ..|....",
		"...|.......|....",
		"..22.......|....",
		"..22-------11...",
		"................",
		"................",
		"................",
		"................",
		"................",
	]
}
