{
	"name": "King of the Hill",
	"author": "KaiN",
	"tiles": [
		"................",
		"................",
		"................",
		".......F........",
		".......|........",
		".......Y........",
		".......Z........",
		"...F-YZZZY-F....",
		".......N........",
		".......N........",
		".......|........",
		".......|........",
		".......1........",
		"................",
		"................",
		"................"
	]
}
