{
	"name": "c11",
	"author": "softiron",
	"tiles": [
		".......22.......",
		"......2222......",
		".....22..22.....",
		".....B----2.....",
		".....22..22.....",
		"......2222......",
		".......22.......",
		"......2222......",
		".....12..22.....",
		".....1----2.....",
		".....12..22.....",
		"......2222......",
		".......22.......",
		"......2222......",
		".....22..22.....",
		".....2----B....."
	]
}
