{
	"name": "Supply chain",
	"author": "KaiN",
	"tiles": [
		"...........2....",
		"..N--------22...",
		"..|........2....",
		"..|.............",
		"..|.............",
		"..|.............",
		"..E----------1..",
		"..|..........|..",
		"..|..........|..",
		"..|..........|..",
		"..N..........|..",
		"..|..........|..",
		"..|..........|..",
		"..|..........|..",
		"..2..........1..",
		"..2..........1.."
	]
}
