{
	"name": "Be Quick Or Be Dead",
	"author": "KaiN",
	"tiles": [
		".ZZZ------N.....",
		".ZZZ......|.....",
		"...|......|.....",
		"...|..2...|..2..",
		"...|.22--NN--22.",
		".N-N..2..N...2..",
		".|.......|......",
		".|.......|......",
		".N-N.....|......",
		"...|.....N----N.",
		"...|..........|.",
		".N-N..........|.",
		".|............|.",
		".|............|.",
		"333......11---N.",
		"333............."
	]
}
