{
	"name": "Step By Step",
	"author": "KaiN",
	"tiles": [
		"................",
		"....2--N--N.....",
		"....|..|..|.....",
		"....|..|..|.....",
		".F--2..|..N--Z..",
		".|.....|.....|..",
		".|.....2.....|..",
		".B....B2B....Y..",
		".|.....2.....|..",
		".|.....|.....|..",
		".F--2..|..N--Z..",
		"....|..|..|.....",
		"....|..|..|.....",
		"....N--1--N.....",
		"................",
		"................"
	]
}
