{
	"name": "Balance Of Power",
	"author": "KaiN",
	"tiles": [
		"................",
		"..33----E----44.",
		"..3.....|.....4.",
		"..|.....|.....|.",
		"..|.....|.....|.",
		"..|.....|.....|.",
		"..|.....|.....|.",
		"..E-----E-----E.",
		"..|.....|.....|.",
		"..|.....|.....|.",
		"..|.....|.....|.",
		"..|.....|.....|.",
		"..|.....|.....|.",
		"..3.....|.....4.",
		"..33----E----44.",
		"................"
	]
}
