{
	"name": "c16",
	"author": "Softiron",
	"tiles": [
		"...33--1--33....",
		"...33--1--33....",
		"..C33..|..33C...",
		".......|........",
		".......|........",
		".......|........",
		".......|........",
		".......|........",
		".......Y........",
		".......|........",
		".......|........",
		".......|........",
		".......|........",
		".......|........",
		".......|........",
		"3------E------G."
	]
}
