{
	"name": "c17",
	"author": "Softiron",
	"tiles": [
		"................",
		"................",
		"................",
		"................",
		"................",
		".......2B2......",
		"......BNNN2.....",
		".....2NNNNN2....",
		".....FNNJNNF....",
		".....2NNNNN2....",
		"......2NNNF.....",
		".......2B2......",
		"................",
		"................",
		"................",
		"................"
	]
}
