{
	"name": "3 stars",
	"author": "Softiron",
	"tiles": [
		"................",
		"................",
		"................",
		"................",
		"..1...........3.",
		".111----Z----333",
		"..1.....|.....3.",
		"..|.....|.....|.",
		"..|.....|.....|.",
		"..|.....|.....|.",
		"..|.....2.....|.",
		"..X----222----Y.",
		"........2.......",
		"................",
		"................",
		"................"
	]
}
