{
	"name": "Five forts",
	"author": "Softiron",
	"players": 4,
	"tiles": [
		"..............",
		".1N........N2.",
		".NN--N--N--NN.",
		".|..........|.",
		".N....NN----N.",
		".N----NN....N.",
		".|..........|.",
		".NN--N--N--NN.",
		".3N........N4.",
		".............."
	]
}
