{
	"name": "cube",
	"author": "softiron",
	"tiles": [
		"................",
		"................",
		"................",
		"................",
		"....3-N-N-N-1...",
		"....|.|.|.|.|...",
		"....N-Y-Z-X-N...",
		"....|.|.|.|.|...",
		"....N-Z-X-Y-N...",
		"....|.|.|.|.|...",
		"....N-Y-Z-X-N...",
		"....|.|.|.|.|...",
		"....2-N-N-N-4...",
		"................",
		"................",
		"................",
	]
}
