{
	"name": "kriss",
	"author": "softiron",
	"tiles": [
		".N............N.",
		"N+N..........N+N",
		".N+Z........N+N.",
		"..N+X......N+Z..",
		"...N+Y....N+X...",
		"....N+1..3+Y....",
		".....11ZY33.....",
		"......Y++Z......",
		"......Z++Y......",
		".....44YZ22.....",
		"....N+4..2+Y....",
		"...N+Y....N+X...",
		"..N+X......N+Z..",
		".N+Z........N+N.",
		"N+N..........N+N",
		".N............N.",
	]
}
