{
	"name": "kross",
	"author": "softiron",
	"tiles": [
		"................",
		"................",
		"........YZ......",
		"........XN......",
		"........||......",
		".....XN-21-NX...",
		".....YZ-12-YZ...",
		"........||......",
		"........NX......",
		"........ZY......",
		"................",
		"................",
		"................",
		"................",
		"................",
		"................",
	]
}
