{
	"name": "Arms Race",
	"author": "Softiron",
	"tiles": [
		"11------------44",
		"11----N..N----44",
		"||....|..|....||",
		"||....|..|....||",
		"||....|..|....||",
		"||....|..|....||",
		"|N----NNNN----N|",
		"|.....NYZN.....|",
		"|.....NZYN.....|",
		"|N----NNNN----N|",
		"||....|..|....||",
		"||....|..|....||",
		"||....|..|....||",
		"||....|..|....||",
		"22----N..N----33",
		"22------------33"
	]
}
